"Ano","1.1. Formação Florestal","1.2. Formação Savânica","2.2. Formação Campestre (Campo)","3.1. Pastagem","3.2.1. Lavoura Temporária","3.2.2. Lavoura Perene","3.3. Floresta Plantada","3.4. Mosaico de Usos","4.2. Infraestrutura Urbana","5.1. Rio, Lago e Oceano"
1985,0,0,0,0,0,0,0,1,0,0
1986,0,0,0,0,0,0,0,1,0,0
1987,0,0,0,0,0,0,0,1,0,0
1988,0,0,0,0,0,0,0,1,0,0
1989,0,0,0,0,0,0,0,1,0,0
1990,0,0,0,0,0,0,0,1,0,0
1991,0,0,0,0,0,0,0,1,0,0
1992,0,0,0,0,0,0,0,1,0,0
1993,0,0,0,0,0,0,0,1,0,0
1994,0,0,0,0,0,0,0,1,0,0
1995,0,0,0,0,0,0,0,1,0,0
1996,0,0,0,0,0,0,0,1,0,0
1997,0,0,0,0,0,0,0,1,0,0
1998,0,0,0,0,0,0,0,1,0,0
1999,0,0,0,0,0,0,0,1,0,0
2000,0,0,0,0,0,0,0,1,0,0
2001,0,0,0,0,0,0,0,1,0,0
2002,0,0,0,0,0,0,0,1,0,0
2003,0,0,0,0,0,0,0,1,0,0
2004,0,0,0,0,0,0,0,1,0,0
2005,0,0,0,0,0,0,0,1,0,0
2006,0,0,0,0,0,0,0,1,0,0
2007,0,0,0,0,0,0,0,1,0,0
2008,0,0,0,0,0,0,0,1,0,0
2009,0,0,0,0,0,0,0,1,0,0
2010,0,0,0,0,0,0,0,1,0,0
2011,0,0,0,0,0,0,0,1,0,0
2012,0,0,0,0,0,0,0,1,0,0
2013,0,0,0,0,0,0,0,1,0,0
2014,0,0,0,0,0,0,0,1,0,0
2015,0,0,0,0,0,0,0,1,0,0
2016,0,0,0,0,0,0,0,1,0,0
2017,0,0,0,0,0,0,0,1,0,0
2018,0,0,0,0,0,0,0,1,0,0
2019,0,0,0,0,0,0,0,1,0,0
2020,0,0,0,0,0,0,0,1,0,0
2021,0,0,0,0,0,0,0,1,0,0