year;forest;savanna;grassland;pasture;temp crop;permanent crop;forestry;mosaic;urban;water
1985,00;-0,09;-0,25;-0,08;0,00;0,00;0,00;-0,01;0,56;0,00;0,00
1986,00;-0,07;-0,22;-0,08;0,00;0,00;0,00;-0,01;0,62;-0,01;0,00
1987,00;-0,05;-0,20;-0,08;0,00;0,00;0,00;-0,01;0,64;-0,01;0,00
1988,00;-0,05;-0,19;-0,08;0,00;0,00;0,00;-0,01;0,66;0,00;0,00
1989,00;-0,05;-0,18;-0,08;0,00;0,00;0,00;-0,01;0,69;0,00;0,00
1990,00;-0,04;-0,18;-0,08;0,00;0,00;0,00;-0,01;0,69;0,00;0,00
1991,00;-0,04;-0,18;-0,07;0,00;0,00;0,00;-0,01;0,69;0,00;0,00
1992,00;-0,05;-0,17;-0,07;0,00;0,00;0,00;-0,01;0,70;0,00;0,00
1993,00;-0,04;-0,15;-0,07;0,00;0,00;0,00;-0,01;0,72;0,00;0,00
1994,00;-0,04;-0,14;-0,07;0,00;0,00;0,00;-0,01;0,73;-0,01;0,00
1995,00;-0,04;-0,15;-0,06;0,00;0,00;0,00;-0,01;0,73;0,00;0,00
1996,00;-0,04;-0,14;-0,06;0,00;0,00;0,00;0,00;0,75;0,00;0,00
1997,00;-0,04;-0,14;-0,06;0,00;0,00;0,00;-0,01;0,74;0,00;0,00
1998,00;-0,04;-0,14;-0,05;0,00;0,00;0,00;-0,01;0,76;0,00;0,00
1999,00;-0,04;-0,14;-0,06;0,00;0,00;0,00;0,00;0,75;0,00;0,00
2000,00;-0,04;-0,15;-0,06;0,00;0,00;0,00;-0,01;0,74;0,00;0,00
2001,00;-0,03;-0,16;-0,06;0,00;0,00;0,00;0,00;0,74;0,00;0,00
2002,00;-0,04;-0,16;-0,06;0,00;0,00;0,00;-0,01;0,73;0,00;0,00
2003,00;-0,03;-0,15;-0,05;0,00;0,00;0,00;-0,01;0,75;-0,01;0,00
2004,00;-0,03;-0,14;-0,05;0,00;0,00;0,00;-0,01;0,75;-0,01;0,00
2005,00;-0,04;-0,14;-0,05;0,00;0,00;0,00;-0,01;0,76;-0,01;0,00
2006,00;-0,04;-0,14;-0,05;0,00;0,00;0,00;-0,01;0,75;-0,01;0,00
2007,00;-0,04;-0,15;-0,05;0,00;0,00;0,00;-0,01;0,75;-0,01;0,00
2008,00;-0,04;-0,14;-0,05;0,00;0,00;0,00;-0,02;0,75;-0,01;0,00
2009,00;-0,04;-0,14;-0,05;0,00;0,00;0,00;-0,02;0,75;-0,01;0,00
2010,00;-0,04;-0,14;-0,05;0,00;0,00;0,00;-0,02;0,74;-0,01;0,00
2011,00;-0,04;-0,13;-0,05;0,00;0,00;0,00;-0,03;0,75;-0,01;0,00
2012,00;-0,04;-0,12;-0,05;0,00;0,00;0,00;-0,03;0,76;-0,01;0,00
2013,00;-0,03;-0,11;-0,05;0,00;0,00;0,00;-0,02;0,77;-0,01;0,00
2014,00;-0,03;-0,11;-0,05;0,00;0,00;0,00;-0,02;0,79;-0,01;0,00
2015,00;-0,04;-0,11;-0,05;0,00;0,00;0,00;-0,03;0,78;0,00;0,00
2016,00;-0,04;-0,11;-0,05;0,00;0,00;0,00;-0,03;0,77;-0,01;0,00
2017,00;-0,04;-0,12;-0,05;0,00;0,00;0,00;-0,03;0,75;0,00;0,00
2018,00;-0,04;-0,12;-0,05;0,00;0,00;0,00;-0,04;0,76;0,00;0,00
